BLU = "countries/BlueHorde.txt"
ZNG = "countries/Zangitania.txt"
BRY = "countries/BrythonKingdom.txt"
BAE = "countries/Baetica.txt"
SAB = "countries/Sabaria.txt"
LUS = "countries/Lusitania.txt"
GTC = "countries/Gotica.txt"
GLL = "countries/Gallia.txt"
GAE = "countries/Gaetulia.txt"
LTN = "countries/Lautana.txt"
SYP = "countries/Syphax.txt"
NMD = "countries/Numidia.txt"
MSL = "countries/Maessylia.txt"
KHZ = "countries/Khazaria.txt"
LKH = "countries/Lakhmids.txt"
UZI = "countries/Huzistan.txt"
MDY = "countries/Media.txt"
NTK = "countries/Enetkheg.txt"
YDV = "countries/Yadava.txt"
SIN = "countries/Sinaye.txt"
MQD = "countries/Maqedonia.txt"
RML = "countries/Romylia.txt"
PMN = "countries/Pammongrii.txt"
DKA = "countries/Dakya.txt"
ILY = "countries/Lirya.txt"
NSE = "countries/NorthSeaEmpire.txt"
GRI = "countries/Grico.txt"
MRS = "countries/MoravoSerbia.txt"
SCN = "countries/Scania.txt"
JMT = "countries/Jamtland.txt"